x000000000000
1111111111111
100000C0000C1
10C000000XCC1
1PCC0000CCCE1
1111111111111
